6 4 4 4 4 4 4 4 4 4 4 4 4 4 4 4 4 4 4 4 4 4 4 4 4 4 4 4 4 5
3 6 4 4 4 4 4 4 4 4 4 4 4 4 5 6 4 4 4 4 4 4 4 4 4 4 4 4 5 3
3 3 0 0 0 0 0 0 0 0 0 0 0 0 3 3 0 0 0 0 0 0 0 0 0 0 0 0 3 3
3 3 0 6 4 4 5 0 6 4 4 4 5 0 3 3 0 6 4 4 4 5 0 6 4 4 5 0 3 3
3 3 0 3 10 10 3 0 3 10 10 10 3 0 3 3 0 3 10 10 10 3 0 3 10 10 3 0 3 3
3 3 0 7 4 4 8 0 7 4 4 4 8 0 7 8 0 7 4 4 4 8 0 7 4 4 8 0 3 3
3 3 0 0 0 0 0 0 0 0 0 0 0 0 0 0 0 0 0 0 0 0 0 0 0 0 0 0 3 3
3 3 0 6 4 4 5 0 6 5 0 6 4 4 4 4 4 4 5 0 6 5 0 6 4 4 5 0 3 3
3 3 0 7 4 4 8 0 3 3 0 7 4 4 5 6 4 4 8 0 3 3 0 7 4 4 8 0 3 3
3 3 0 0 0 0 0 0 3 3 0 0 0 0 3 3 0 0 0 0 3 3 0 0 0 0 0 0 3 3
3 7 4 4 4 4 5 0 3 7 4 4 5 0 3 3 0 6 4 4 8 3 0 6 4 4 4 4 8 3
3 10 10 10 10 10 3 0 3 6 4 4 8 0 7 8 0 7 4 4 5 3 0 3 10 10 10 10 10 3
3 10 10 10 10 10 3 0 3 3 0 0 0 0 0 0 0 0 0 0 3 3 0 3 10 10 10 10 10 3
3 10 10 10 10 10 3 0 3 3 0 6 4 4 9 9 4 4 5 0 3 3 0 3 10 10 10 10 10 3
3 6 4 4 4 4 8 0 7 8 0 3 0 0 0 0 0 0 3 0 7 8 0 7 4 4 4 4 5 3
3 3 0 0 0 0 0 0 0 0 0 3 0 0 0 0 0 0 3 0 0 0 0 0 0 0 0 0 3 3
3 7 4 4 4 4 5 0 6 5 0 3 0 0 0 0 0 0 3 0 6 5 0 6 4 4 4 4 8 3
3 10 10 10 10 10 3 0 3 3 0 7 4 4 4 4 4 4 8 0 3 3 0 3 10 10 10 10 10 3
3 10 10 10 10 10 3 0 3 3 0 0 0 0 0 0 0 0 0 0 3 3 0 3 10 10 10 10 10 3
3 10 10 10 10 10 3 0 3 3 0 6 4 4 4 4 4 4 5 0 3 3 0 3 10 10 10 10 10 3
3 6 4 4 4 4 8 0 7 8 0 7 4 4 5 6 4 4 8 0 7 8 0 7 4 4 4 4 5 3
3 3 0 0 0 0 0 0 0 0 0 0 0 0 3 3 0 0 0 0 0 0 0 0 0 0 0 0 3 3
3 3 0 6 4 4 5 0 6 4 4 4 5 0 3 3 0 6 4 4 4 5 0 6 4 4 5 0 3 3
3 3 0 7 4 5 3 0 7 4 4 4 8 0 7 8 0 7 4 4 4 8 0 3 6 4 8 0 3 3
3 3 0 0 0 3 3 0 0 0 0 0 0 0 0 0 0 0 0 0 0 0 0 3 3 0 0 0 3 3
3 7 4 5 0 3 3 0 6 5 0 6 4 4 4 4 4 4 5 0 6 5 0 3 3 0 6 4 8 3
3 6 4 8 0 7 8 0 3 3 0 7 4 4 5 6 4 4 8 0 3 3 0 7 8 0 7 4 5 3
3 3 0 0 0 0 0 0 3 3 0 0 0 0 3 3 0 0 0 0 3 3 0 0 0 0 0 0 3 3
3 3 0 6 4 4 4 4 8 7 4 4 5 0 3 3 0 6 4 4 8 7 4 4 4 4 5 0 3 3
3 3 0 7 4 4 4 4 4 4 4 4 8 0 7 8 0 7 4 4 4 4 4 4 4 4 8 0 3 3
3 3 0 0 0 0 0 0 0 0 0 0 0 0 0 0 0 0 0 0 0 0 0 0 0 0 0 0 3 3
3 7 4 4 4 4 4 4 4 4 4 4 4 4 4 4 4 4 4 4 4 4 4 4 4 4 4 4 8 3
7 4 4 4 4 4 4 4 4 4 4 4 4 4 4 4 4 4 4 4 4 4 4 4 4 4 4 4 4 8